0000xcQQQQQQQQQQQQQQQQQQQQQQQQQQQQQQQQQQQQQQQQQQQQQQQQQQQQQQQQQQQQQQQQQQQQQQQQQQQQQQQQQQQQQQQQQQQQQQQQQQQQQQQQQQQQQQQQQQQQQQQQQQQQQQQQQQQQQQQQQQQQQQQQQQQQQQQQQQQQQQQQQQQQQQQQQQQQQQQQQQQQQQQQQQQQQQQQQQQQQQQQQQQQQQQQQQQQQQQQQQQQQQQQQQQQQQQQQQQQQQQQQQQQQQQQQQQQQQQQQQQQQQQQQQQQQQQQQQQQQQQQQQQQQQQQQzQQQQQQQQQQQQQQdz00000000000000000000000000000000000000xcQQQQQQQQQQQQQQQQQQQQQQQQQQQQQQQQQQQ
00000xcQQQQQQQQQQQQQQQQQQQQQQQQQQQQQQQQQQQQQQQQQQQQQQQQQQQQQQQQQQQQQQQQQQQQQQQQQQQQQQQQQQQQQQQQQQQQQQQQQQQQQQQQQQQQQQQQQQQQQQQQQQQQQQQQQQQQQQQQQQQQQQQQQQQQQQQQQQQQQQQQQQQQQQQQQQQQQQQQQQQQQQQQQQQQQQQQQQQQQQQQQQQQQQQQQQQQQQQQQQQQQQQQQQQQQQQQQQQQQQQQQQQQQQQQQQQQQQQQQQQQQQQQQQQQQQQQQQQQQQQQQQQQQQQz00000000QQQQQQQdz0000000000000000000000000000000000000000XcQQQQQQ00000000000QQQQQQQQQQQQQQQQ
000000xcQQQQQQQQQQQQQQQQQQQQQQQQQQQQQQQQQQQQQQQQQQQQQQQQQQQQQQQQQQQQQQQQQQQQQQQQQQQQQQQQQQQQQQQQQQQQQQQQQQQQQQQQQQQQQQQQQQQQQQQQQQQQQQQQQQQQQQQQQQQQQQQQQQQQQQQQQQQQQQQQQQQQQQQQQQQQQQQQQQQQQQQQQQQQQQQQQQQQQQQQQQQQQQQQQQQQQQQQQQQQQQQQQQQQQQQQQQQQQQQQQQQQQQQQQQQQQQQQQQQQQQQQQQQQQQQQQQQQQQQQQQQQQR00000000000QQdz000000000000000000000000000000000000000000Xc0000000000QQQQ0QQ000QQQQQQQQQQQQQQ
0000000xyyyyyyyyyyyyyyyyyyyyyyyyyyyyyyyyyyyyyyyyyyyyycQQQQQQQQQQQQQQQQQQQQQQQQQQQQQQdyyyyyyyyyyyyyyyyyyyyyyyyyyyyyyyyyyyyyyyyyyyyyyyyyyyyyyyyyyyyyyyyyyyyyyyyyyyyyyyyyyyyyyyyyyyyyyyyyyyyyyyyyyyyyyyycQdyyyyyyyyyyyyyyyyyyyyyyyyyyyyyyyyyyyyyyyyyyyyyyyyyyyyyyyyyyyyyyyyyyyyyyyyyyyyyyyyyyyyyyyyycQQQR000000000000000000000000000000000000000000000000000000000000000000000000000000XcQQQQQQQQQQQQQ
00000000000000000000000000000000000000000000000000000LQQQQQQQQQQQQQQQQQQQQQQQQQQQQQQR0000000000000000000000000000000000000000000000000000000000000000000000000000000000000000000000C000C000C000C000C0LQR00000000000000000000000000000000000000000000000000000000000000000000000000000000000000000xcQQqYYYZ0000000000000000000000000000000000000000000000000000000000000000000000XcQQQQQQQQQQQQQQQQQ
00000000000000000000000000000000000000000000000000000xycQQQQQQQQQQQQQQQQQQQQQQQQQQdyz00000000000000000000000000000000000000000000000000000000000000000b00000000b000000000000000000C0C0C0C0C0C0C0C0C0CLQR00000000000000000000000000000000000b00000000000000000000b000000000000000000000000000000000xcQQQQQqYYZ000000000002220000000000000000000000000000000000000020002000200000XcQQQQQQQQQQQQQQQQQQ
0000000000000000000000000000000000000000000000000000000LQQQQQQQQQQQQQQQQQQQQQQQQQQR000000000000000000000000000000000000000000000000C0C0C0C000000B00000000000000000000000B0000000000C000C000C000C000C0LQR0000000000000000000000000000000000000000585758575850000000000000000000000000000000000000000xcQQQQQQQqYYZ00002000000000000000002220002002200000000000000000000000000XcQQQQQQQQQQQQQQQQQQQQQQ
0000000000000000000000000000000000000000000000000000000xyyyyyyyyyyyyyyyyyyyyyyyyyyz000000000000000000000000000000000000000000000007585758570000000000000000000000000000000000000XYYYYYYYYYYYYYYYYYYYYaQR0000000000000CC0CC00000000000000000000000000000000000000000000000000000000000000000000000000xcQQQQQQQQQqZ000000000022200022200000000000000000000000222000000000000XcQQQQQQQQQQQQQQQQQQQQQQQ
000000000000000000000000000000000000000000000000000000000000000000000000000000000000000000000000000000000000000000000000000000000000000000000000000000000000000000000000000000XYaQQQQQQQQQQQQQQQQQQQQQQR000000000000C00C00C00000000000000000000000000000000000000000000000000000000000000000000000000xyyyyyyyyyyz00000000000000000000000000000000000000000000000000000xyyyyyyyyyyyyyyyyyyyyyyyyyyyy
00000000000000000000000000000000000577500000000000000000000000000000000000000000000000000000000000000000000000000000000000000000000000000000000000000000000000000000000000000XaQQQQQQQQQQQQQQQQQQQQQQQQR0000000000000C000C0000000000000000000000000000000000000000000000000000000000000000000000000000000000000000080000000000000000000000000000000000022022000200000000000000000000000000000000000
00000000000000000000000000000000000000000000000000000000C0C000000C0C000000C0C0000000000000000000000000000000000000000000000XYYYYYYYYYYYYYYYYYYYYYYYYYYYYYYYYYYYYYYYYYYYYYYYYYaQQQQQQQQQQQQQQQQQQQQQQQQQR00000000000000C0C00000000022222222222222222222222222222222222222222222222200058585858500000000000000000000000008800000000008888000000000000000000000000002000000000000000000000000000000000
000000000000000000000000000000000C000000C000000000000000000000000000000000000000000000000000C000000000000000000000000000000Ldyyyyyyyyyyyyyyyyyyyyyyyyyyyyyyyyyyyyyyyyyyyyyyyyyyyyyyyyyyyyyyyyyyyyyyyyyyz000000000000000C0000000000000000000000000000000000000000000000000000000002000000000000000000000000000000XZ00000000000000000000000000000000000000000000000000XZ00000000000000000000000000000
0000000000000000000000000000000C0000000000C0000000000057585750005585750005755857500000C00000000000C0000000XYZ000000XYYYYYYYaR0000000000000000000000000000000000000000000000000000000000000000000000000000000000000000000000000000000000000000000000000000000000000000000000000000200000000000000000000000000000XaR00000000000000000000000000000000000000000000000000LqZ0000000000000000000000000000
00000000000000000000000000000000000XYYZ0000000000000000000000000000000000000000000000000000000000000000000LQR000000xyyyyyyyyz00000000000000000000000000000000000000000000000000000000000000000000000000000000000000000000000000000000000000000000000000000000000000000000000000002000M0000M0000000000000000000XaQR00000000000000000000000000000000000000000000000000LQqZ000000000000000000000000000
00000000000000000000000000XYYYZ0000LQQR0000XYYYYYZ00000000000000000000000000000000000000XYZ000XYZ000000000LQqYZ000000000000000000000000000CC0000000000000000000000000000000CC00000000000005758575000000000000000XYYYZ0000XYYYYZ000000000000000000005857585750000000000000000000002222222222222220000000000000XaQQqYYYYYYYYYYYYYYYYYYYYYYYYYYYYYYYYYYYYYYYYYYYYYYYYYYaQQqZ00000000000000000000000000
000000000000000000000000XYaQQQR0000LQQR0000LQQQQQR0000000000000000000000000000000XYYZ000LQR000LQR000XYZ000LQQQR000000000000000000000000000000000000000000000000000000000000000000000000000000000000000000000000XaQQQR0000LQQQQR00000000000000000000000000000000000000000000000000000C000C000C002000000000000XaQQQQQQQQQQQQQQQQQQQQQQQQQQQQQQQQQQQQQQQQQQQQQQQQQQQQQQQQQQqZ0000000000000000000000000
0000000000000000000000XYaQQQQQR0000LQQR0000LQQQQQqYYWWWYYYYYYWWWYYYYYYWWWYYYYYYYYaQQR000LQR000LQR000LQR000LQQQqYZ0000000000000000000000000XZ0000000000000000000000000000000XZ000000000000000000000000000000000XaQQQQR0000LQQQQR0000000000000000000000000000000000000000XZ0000000000C0C0C0C0C0C0200000000000XaQQQQQQQQQQQQQQQQQQQQQQQQQQQQQQQQQQQQQQQQQQQQQQQQQQQQQQQQQQQQqZ000000000000000000000000
00000000000000000000XYaQQQQQQQR0000LQQR0000LQQQQQQQQQQQQQQQQQQQQQQQQQQQQQQQQQQQQQQQQR000LQRWWWLQR000LQRWWWLQQQQQR000000000M0000M000000000XaqZ000000000M0M00000000000000000XaqZ0000000M000M0000000000000000000XaQQQQQR0000LQQQQRWWXZ000XZ000XZ0000000000000000000M0M000XaR00000000000C000C000C0020000000000XaQQQQQQQQQQQQQQQQQQQQQQQQQQQQQQQQQQQQQQQQQQQQQQQQQQQQQQQQQQQQQQqZ0000000000000000F000000
YYYYYYYYYYYYYYYYYYYYaQQQQQQQQQRWWWWLQQRWWWWLQQQQQQQQQQQQQQQQQQQQQQQQQQQQQQQQQQQQQQQQR000LQqYYYaQR000LQqYYYaQQQQQqYYYYYYYYYYYYYYYYYYYYYYYYaQQqYYYYYYYYYYYYYYYYYYYYYYYYYYYYYaQQqYYYYYYYYYYYYYYYYYYYYYYYYYYYYYYYaQQQQQQRWWWWLQQQQqYYaRWWWLRWWWLqYYYYYYYYYYYYYYYYYYYYYYYYYaQRWWWXYYYYYYYYYYYYYYYYYYYYYZWWWXYYYaQQQQQQQQQQQQQQQQQQQQQQQQQQQQQQQQQQQQQQQQQQQQQQQQQQQQQQQQQQQQQQQQq55555555555555555555555
QQQQQQQQQQQQQQQQQQQQQQQQQQQQQQqYYYYaQQqYYYYaQQQQQQQQQQQQQQQQQQQQQQQQQQQQQQQQQQQQQQQQRWWWLQQQQQQQRWWWLQQQQQQQQQQQQQQQQQQQQQQQQQQQQQQQQQQQQQQQQQQQQQQQQQQQQQQQQQQQQQQQQQQQQQQQQQQQQQQQQQQQQQQQQQQQQQQQQQQQQQQQQQQQQQQQqYYYYaQQQQQQQQqYYYaqYYYaQQQQQQQQQQQQQQQQQQQQQQQQQQQQRQQQLQQQQQQQQQQQQQQQQQQQQQq555aQQQQQQQQQQQQQQQQQQQQQQQQQQQQQQQQQQQQQQQQQQQQQQQQQQQQQQQQQQQQQQQQQQQQQQQQQQQQQQQQQQQQQQQQQQQQ
