0000x0QQQQQQQQQQQQQQQQQQQQQQQQQQQQQQQQQQQQQQQQQQQQQQQQQQQQQQQQQQQQQQQQQQQQQQQQQQQQQQQQQQQQQQQQQQQQQQQQQQQQQQQQQQQQQQQQQQQQQQQQQQQQQQQQQQQQQQQQQQQQQQQQQQQQQQQQQQQQQQQQQQQQQQQQQQQQQQQQQQQQQQQQQQQQQQQQQQQQQQQQQQQQQQQQQQQQQQQQQQQQQQQQQQQQQQQQQQQQQQQQQQQQQQQQQQQQQQQQQQQQQQQQQQQQQQQQQQQQQQQQQQQQQQQQQQQQQQQQQQQQQQQQQQQQQQQQQQQQQQQQQQQQQQQQQQQQQQQQQQQQQQQQ
00000x0QQQQQQQQQQQQQQQQQQQQQQQQQQQQQQQQQQQQQQQQQQQQQQQQQQQQQQQQQQQQQQQQQQQQQQQQQQQQQQQQQQQQQQQQQQQQQQQQQQQQQQQQQQQQQQQQQQQQQQQQQQQQQQQQQQQQQQQQQQQQQQQQQQQQQQQQQQQQQQQQQQQQQQQQQQQQQQQQQQQQQQQQQQQQQQQQQQQQQQQQQQQQQQQQQQQQQQQQQQQQQQQQQQQQQQQQQQQQQQQQQQQQQQQQQQQQQQQQQQQQQQQQQQQQQQQQQQQQQQQQQQQQQQQQQQQQQQQQQQQQQQQQQQQQQQQQQQQQQQQQQQQQQQQQQQQQQQQQQQQQQQQ
000000x0QQQQQQQQQQQQQQQQQQQQQQQQQQQQQQQQQQQQQQQQQQQQQQQQQQQQQQQQQQQQQQQQQQQQQQQQQQQQQQQQQQQQQQQQQQQQQQQQQQQQQQQQQQQQQQQQQQQQQQQQQQQQQQQQQQQQQQQQQQQQQQQQQQQQQQQQQQQQQQQQQQQQQQQQQQQQQQQQQQQQQQQQQQQQQQQQQQQQQQQQQQQQQQQQQQQQQQQQQQQQQQQQQQQQQQQQQQQQQQQQQQQQQQQQQQQQQQQQQQQQQQQQQQQQQQQQQQQQQQQQQQQQQQQQQQQQQQQQQQQQQQQQQQQQQQQQQQQQQQQQQQQQQQQQQQQQQQQQQQQQQQ
0000000xyyyyyyyyyyyyyyyyyyyyyyyyyyyyyyyyyyyyyyyyyyyyy0QQQQQQQQQQQQQQQQQQQQQQQQQQQQQQdyyyyyyyyyyyyyyyyyyyyyyyyyyyyyyyyyyyyyyyyyyyyyyyyyyyyyyyyyyyyyyyyyyyyyyyyyyyyyyyyyyyyyyyyyyyyyyyyyyyyyyyyyyyyyyyy0Qdyyyyyyyyyyyyyyyyyyyyyyyyyyyyyyyyyyyyyyyyyyyyyyyyyyyyyyyyyyyyyyyyyyyyyyyyyyyyyyyyyyyyyyyyyyyyyyyyyyyyyyyyyyyyyyyyyyyyyyyyyyyyyyyyyyyyyyyyyyyyyyyyyyyyyy
00000000000000000000000000000000000000000000000000000rQQQQQQQQQQQQQQQQQQQQQQQQQQQQQQR0000000000000000000000000000000000000000000000000000000000000000000000000000000000000000000000C000C000C000C000C0rQR000000000000000000000000000000000000000000000000000000000000000000000000000000000000000000000000000000000000000000000000000000000000000000000000000000
00000000000000000000000000000000000000000000000000000xy0QQQQQQQQQQQQQQQQQQQQQQQQQQdy0000000000000000000000000000000000000000000000000000000000000000000000000000000000000000000000C0C0C0C0C0C0C0C0C0CrQR000000000000000000000000000000000000000000000000000000000000000000000000000000000000000000000000000000000000000000000000000000000000000000000000000000
0000000000000000000000000000000000000000000000000000000rQQQQQQQQQQQQQQQQQQQQQQQQQQR000000000000000000000000000000000000000000000000C0C000000000000000000000000000000000000000000000C000C000C000C000C0rQR000000000000000000000000000000000000000000000000000000000000000000000000000000000000000000000000000000000000000000000000000000000000000000000000000000
0000000000000000000000000000000000000000000000000000000xyyyyyyyyyyyyyyyyyyyyyyyyyy0000000000000000000000000000000000000000000000000000000000000000000000000000000000000000000000XYYYYYYYYYYYYYYYYYYYYaQR0000000000000CC0CC000000000000000000000000000000000000000000000000000000000000000000000000000000000000000000000000000000000000000000000000000000000000
000000000000000000000000000000000000000000000000000000000000000000000000000000000000000000000000000000000000000000000000000000000000000000000000000000000000000000000000000000XYaQQQQQQQQQQQQQQQQQQQQQQR000000000000C00C00C0000000000000000000000000000000000000000000000000000000000000000000000000000000000000000C000000000000000000000000000000000000000000
00000000000000000000000000000000000000000000000000000000000000000000000000000000000000000000000000000000000000000000000000000000000000000000000000000000000000000000000000000XaQQQQQQQQQQQQQQQQQQQQQQQQR0000000000000C000C000000000000000000000000000000000000000000000000000000000000000000000000000000000000000000000000000000000000000000000000000000000000
000000000000000000000000000000000000000000000000000000000000000000000000000000000000000000000000000000000000000000000000000XYYYYYYYYYYYYYYYYYYYYYYYYYYYYYYYYYYYYYYYYYYYYYYYYYaQQQQQQQQQQQQQQQQQQQQQQQQQR00000000000000C0C0000000000000000000000000000000000000000000000000000000000000000000000000000000000000000000000000000000000000000000000000XZ0000000000
00000000000000000000000000000000C00000000C00000000000000000000000000000000000000000000000000C000000000000000000000000000000rdyyyyyyyyyyyyyyyyyyyyyyyyyyyyyyyyyyyyyyyyyyyyyyyyyyyyyyyyyyyyyyyyyyyyyyyyyy0000000000000000C0000000000000000000000000000000000000000000000000000000000000000000000000000000000000000XZ000XZ00000000000000000000000000XaR0000000000
00000000000000000000000000000000000000000000000000000000000000000000000000000000000000C00000000000C0000000XYZ000000XYYYYYYYaR0000000000000000000000000000000000000000000000000000000000000000000000000000000000000000000000000000000000000000000000000000000000000000000000000000000000000000000000000000000000XaR000rqZ000000000000000000000000XaQR0000000000
00000000000000000000000000000000000XYYZ0000000000000000000000000000000000000000000000000000000000000000000rQR000000xyyyyyyyyy000000000000000000000000000000000000000000000000000000000000000000000000000000000000000000000000000000000000000000000000000000000000000000000000000000000000000000000000000000000XaQR000rQqZ0000000000000000000000XaQQR0000000000
00000000000000000000000000XYYYZ0000rQQR0000XYYYYYZ00000000000000000000000000000000000000XYZ000XYZ000000000rQqYZ0000000000000000000000000000000000000000000000000000000000000000000000000000000000000000000000000XYYYZ0000XYYYYZ000000000000000000000000000000000000000000000000000000000000000000000000000000XaQQR000rQQqZ00000000000000000000XaQQQR0000000000
000000000000000000000000XYaQQQR0000rQQR0000rQQQQQR0000000000000000000000000000000XYYZ000rQR000rQR000XYZ000rQQQR000000000000000000000000000000000000000000000000000000000000000000000000000000000000000000000000XaQQQR0000rQQQQR00000000000000000000000000000000000000000000000000000000000000000000000000000XaQQQR000rQQQqZ000000000000000000XaQQQQR0000000000
0000000000000000000000XYaQQQQQR0000rQQR0000rQQQQQqYZ00000000000000000000000000000rQQR000rQR000rQR000rQR000rQQQqYZ000000000000000000000000000000000000000000000000000000000000000000000000000000000000000000000XaQQQQR0000rQQQQR0000000000000000000000000000000000000000000000000000000000000000000000000000XaQQQQR000rQQQQqZ0000000000000000XaQQQQQR0000000000
00000000000000000000XYaQQQQQQQR0000rQQR0000rQQQQQQQR00000000000000000000000000000rQQR000rQRSSSrQR000rQRSSSrQQQQQR00000000000000000000000000000000000000000000000000000000000000000000000000000000000000000000XaQQQQQR0000rQQQQRSSXZ000XZ000XZ0000000000000000000000000000000000000000000000000000000000000XaQQQQQRSSSrQQQQQqZ00000000000000XaQQQQQQR0000000000
YYYYYYYYYYYYYYYYYYYYaQQQQQQQQQRSSSSrQQRSSSSrQQQQQQQqYYYYYYYYYYYYYYYYYYYYYYYYYYYYYaQQR000rQqYYYaQR000rQqYYYaQQQQQqYYYYYYYYYYYYYYYYYYYYYYYYYYYYYYYYYYYYYYYYYYYYYYYYYYYYYYYYYYYYYYYYYYYYYYYYYYYYYYYYYYYYYYYYYYYYaQQQQQQRWWWWrQQQQRYYaRWWWrRWWWrqYYYYYYYYYYYYYYYYYYYYYYYYYYYYYYYYYYYYYYYYYYYYYYYYYYYYYYYYYYYYYaQQQQQQqYYYaQQQQQQqYYYYYYYYYYYYYYaQQQQQQQqYYYYYYYYYY
QQQQQQQQQQQQQQQQQQQQQQQQQQQQQQqYYYYaQQqYYYYaQQQQQQQQQQQQQQQQQQQQQQQQQQQQQQQQQQQQQQQQRWWWrQQQQQQQRWWWrQQQQQQQQQQQQQQQQQQQQQQQQQQQQQQQQQQQQQQQQQQQQQQQQQQQQQQQQQQQQQQQQQQQQQQQQQQQQQQQQQQQQQQQQQQQQQQQQQQQQQQQQQQQQQQQqYYYYaQQQQQQQQqYYYaqYYYaQQQQQQQQQQQQQQQQQQQQQQQQQQQQQQQQQQQQQQQQQQQQQQQQQQQQQQQQQQQQQQQQQQQQQQQQQQQQQQQQQQQQQQQQQQQQQQQQQQQQQQQQQQQQQQQQQQ
