0000xcQQQQQQQQQQQQQQQQQQQQQQQQQQQQQQQQQQQQQQQQQQQQQQQQQQQQQQQQQQQQQQQQQQQQQQQQQQQQQQQQQQQQQQQQQQQQQQQQQQQQQQQQQQQQQQQQQQQQQQQQQQQQQQQQQQQQQQQQQQQQQQQQQQQQQQQQQQQQQQQQQQQQQQQQQQQQQQQQQQQQQQQQQQQQQQQQQQQQQQQQQQQQQQQQQQQQQQQQQQQQQQQQQQQQQQQQQQQQQQQQQQQQQQQQQQQQQQQQQQQQQQQQQQQQQQQQQQQQQQQQQQQQQQQQQQQQQQQQQQdz0000000000000000000000000000000000000000000xcQQQQQQQQQQQQQQQQQQQQQQQQQQQQQ
00000xcQQQQQQQQQQQQQQQQQQQQQQQQQQQQQQQQQQQQQQQQQQQQQQQQQQQQQQQQQQQQQQQQQQQQQQQQQQQQQQQQQQQQQQQQQQQQQQQQQQQQQQQQQQQQQQQQQQQQQQQQQQQQQQQQQQQQQQQQQQQQQQQQQQQQQQQQQQQQQQQQQQQQQQQQQQQQQQQQQQQQQQQQQQQQQQQQQQQQQQQQQQQQQQQQQQQQQQQQQQQQQQQQQQQQQQQQQQQQQQQQQQQQQQQQQQQQQQQQQQQQQQQQQQQQQQQQQQQQQQQQQQQQQQQQQQQQQQQQdz000000000000000000000000000000000000000000000xcQQQQQQQQQQQQQQQQQQQQQQQQQQQQ
000000xcQQQQQQQQQQQQQQQQQQQQQQQQQQQQQQQQQQQQQQQQQQQQQQQQQQQQQQQQQQQQQQQQQQQQQQQQQQQQQQQQQQQQQQQQQQQQQQQQQQQQQQQQQQQQQQQQQQQQQQQQQQQQQQQQQQQQQQQQQQQQQQQQQQQQQQQQQQQQQQQQQQQQQQQQQQQQQQQQQQQQQQQQQQQQQQQQQQQQQQQQQQQQQQQQQQQQQQQQQQQQQQQQQQQQQQQQQQQQQQQQQQQQQQQQQQQQQQQQQQQQQQQQQQQQQQQQQQQQQQQQQQQQQQQQQQQQQQdz00000000000000000000000000000000000000000000000xcQQQQQQQQQQQQQQQQQQQQQQQQQQQ
0000000xyyyyyyyyyyyyyyyyyyyyyyyyyyyyyyyyyyyyyyyyyyyyycQQQQQQQQQQQQQQQQQQQQQQQQQQQQQQdyyyyyyyyyyyyyyyyyyyyyyyyyyyyyyyyyyyyyyyyyyyyyyyyyyyyyyyyyyyyyyyyyyyyyyyyyyyyyyyyyyyyyyyyyyyyyyyyyyyyyyyyyyyyyyyycQdyyyyyyyyyyyyyyyyyyyyyyyyyyyyyyyyyyyyyyyyyyyyyyyyyyyyyyyyyyyyyyyyyyyyyyyyyyyyyyyyyyyyyyyyyyyyyyyyyyyyyyz0000000000000000000000000000000000000000000000000xyyyyyyyyyyyyyyyyyyyyyyyyyyy
00000000000000000000000000000000000000000000000000000LQQQQQQQQQQQQQQQQQQQQQQQQQQQQQQR0000000000000000000000000000000000000000000000000000000000000000000000000000000000000000000000C000C000C000C000C0LQR000000000000000000000000000000000000000000000000000000000000000000000000000000000000000000000000000000000000000000000000000000000000000000000000000000000000000000000000000000000000
00000000000000000000000000000000000000000000000000000xycQQQQQQQQQQQQQQQQQQQQQQQQQQdyz00000000000000000000000000000000000000000000000000000000000000000b00000000b000000000000000000C0C0C0C0C0C0C0C0C0CLQR00000000000000000000000000000000000b00000000000000000000b000000000000000000000000000000000000000000000000000000000000000000000000000000000000000000000000000000000000000000000000000
0000000000000000000000000000000000000000000000000000000LQQQQQQQQQQQQQQQQQQQQQQQQQQR000000000000000000000000000000000000000000000000C0C0000000000B00000000000000000000000B0000000000C000C000C000C000C0LQR000000000000000000000000000000000000000000000575857500000000000000000000000000000000000000000000000000000000000000000000000000000000000000000000000000000000000000000000000000000000
0000000000000000000000000000000000000000000000000000000xyyyyyyyyyyyyyyyyyyyyyyyyyyz000000000000000000000000000000000000000000000007585700000000000000000000000000000000000000000XYYYYYYYYYYYYYYYYYYYYaQR00000000000000000000000000000000000000000000000000000000000000C0C0000000000000000000000000000000000000000000000000000000000000000000000000000000000000000000000000000000000000000000
000000000000000000000000000000000000000000000000000000000000000000000000000000000000000000000000000000000000000000000000000000000000000000000000000000000000000000000000000000XYaQQQQQQQQQQQQQQQQQQQQQQR0000000000000CC0CC0000000000000000000000000000000000000000000C0C0C000000000000000000000000000000000000000000000000000000000000000000000000000000000000000000000000000000000000000000
00000000000000000000000000000000000577500000000000000000000000000000000000000000000000000000000000000000000000000000000000000000000000000000000000000000000000000000000000000XaQQQQQQQQQQQQQQQQQQQQQQQQR000000000000C00C00C000000000000000000000000M0000000000000000000000M00000000000000000000000000000000000000000000000000000000000000000000000000000000000000000000000000000000000000000
00000000000000000000000000000000000000000000000000000000C0C000000C0C000000C0C0000000000000000000000000000000000000000000000XYYYYYYYYYYYYYYYYYYYYYYYYYYYYYYYYYYYYYYYYYYYYYYYYYaQQQQQQQQQQQQQQQQQQQQQQQQQR0000000000000C000C000000002222222222222222222222222222222222222222222222220000000000000000000000000000000000000000000000000000000000000000000000000000000000000000000000000000000000
000000000000000000000000000000000C000000C000000000000000000000000000000000000000000000000000C000000000000000000000000000000Ldyyyyyyyyyyyyyyyyyyyyyyyyyyyyyyyyyyyyyyyyyyyyyyyyyyyyyyyyyyyyyyyyyyyyyyyyyyz00000000000000C0C000000000000000000000000000000000000000000000000000000002000000000000000000000000000000XZ0000000000000000000000000000000000000000000XZ00000000000000000000000000000
0000000000000000000000000000000C0000000000C0000000000057575750005575750005755750000000C00000000000C0000000XYZ000000XYYYYYYYaR000000000000000000000000000000000000000000000000000000000000000000000000000000000000000000C000000000000000000000000000000000000000000000000000000000200000000000000000000000000000XaR0000000000000000000000000000000000000000000LqZ0000000000000000000000000000
00000000000000000000000000000000000XYYZ0000000000000000000000000000000000000000000000000000000000000000000LQR000000xyyyyyyyyy000000000000000000000000000000000000000000000000000000000000000000000000000000000000000000000000000000000000000000000000000000000000000000000000000020000M000M0000000000000000000XaQR0000000000000000000000000000000000000000000LQqZ000000000000000000000000000
00000000000000000000000000XYYYZ0000LQQR0000XYYYYYZ00000000000000000000000000000000000000XYZ000XYZ000000000LQqYZ000000000000000000000000000CC0000000000000000000000000000000CC00000000000005758575000000000000000XYYYZ0000XYYYYZ000000000000000000005575585500000000000000000000002222222222222220000000000000XaQQqYYYYYYYYYYYYYYYYYYYYYYYYYYYYYYYYYYYYYYYYYYYaQQqZ00000000000000000000000000
000000000000000000000000XYaQQQR0000LQQR0000LQQQQQR0000000000000000000000000000000XYYZ000LQR000LQR000XYZ000LQQQR000000000000000000000000000000000000000000000000000000000000000000000000000000000000000000000000XaQQQR0000LQQQQR00000000000000000000000000000000000000000000000000000C000C000C002000000000000XaQQQQQQQQQQQQQQQQQQQQQQQQQQQQQQQQQQQQQQQQQQQQQQQQQQQqZ0000000000000000000000000
0000000000000000000000XYaQQQQQR0000LQQR0000LQQQQQqYYWWWYYYYYYWWWYYYYYYWWWYYYYYYYYaQQR000LQR000LQR000LQR000LQQQqYZ0000000000000000000000000XZ0000000000000000000000000000000XZ000000000000000000000000000000000XaQQQQR0000LQQQQR0000000000000000000000000000000000000000XZ0000000000C0C0C0C0C0C0200000000000XaQQQQQQQQQQQQQQQQQQQQQQQQQQQQQQQQQQQQQQQQQQQQQQQQQQQQQqZ000000000000000000000000
00000000000000000000XYaQQQQQQQR0000LQQR0000LQQQQQQQQQQQQQQQQQQQQQQQQQQQQQQQQQQQQQQQQR000LQRWWWLQR000LQRWWWLQQQQQR000000000M0000M000000000XaqZ000000000M0M00000000000000000XaqZ0000000M000M0000000000000000000XaQQQQQR0000LQQQQRWWXZ000XZ000XZ0000000000000000000M0M000XaR00000000000C000C000C0020000000000XaQQQQQQQQQQQQQQQQQQQQQQQQQQQQQQQQQQQQQQQQQQQQQQQQQQQQQQQqZ00000000000000000000000
YYYYYYYYYYYYYYYYYYYYaQQQQQQQQQRWWWWLQQRWWWWLQQQQQQQQQQQQQQQQQQQQQQQQQQQQQQQQQQQQQQQQR000LQqYYYaQR000LQqYYYaQQQQQqYYYYYYYYYYYYYYYYYYYYYYYYaQQqYYYYYYYYYYYYYYYYYYYYYYYYYYYYYaQQqYYYYYYYYYYYYYYYYYYYYYYYYYYYYYYYaQQQQQQRWWWWLQQQQqYYaRWWWLRWWWLqYYYYYYYYYYYYYYYYYYYYYYYYYaQRWWWXYYYYYYYYYYYYYYYYYYYYYZWWWXYYYaQQQQQQQQQQQQQQQQQQQQQQQQQQQQQQQQQQQQQQQQQQQQQQQQQQQQQQQQQq55555555555555555555555
QQQQQQQQQQQQQQQQQQQQQQQQQQQQQQqYYYYaQQqYYYYaQQQQQQQQQQQQQQQQQQQQQQQQQQQQQQQQQQQQQQQQRWWWLQQQQQQQRWWWLQQQQQQQQQQQQQQQQQQQQQQQQQQQQQQQQQQQQQQQQQQQQQQQQQQQQQQQQQQQQQQQQQQQQQQQQQQQQQQQQQQQQQQQQQQQQQQQQQQQQQQQQQQQQQQQqYYYYaQQQQQQQQqYYYaqYYYaQQQQQQQQQQQQQQQQQQQQQQQQQQQQRQQQLQQQQQQQQQQQQQQQQQQQQQqYYYaQQQQQQQQQQQQQQQQQQQQQQQQQQQQQQQQQQQQQQQQQQQQQQQQQQQQQQQQQQQQQQQQQQQQQQQQQQQQQQQQQQQQQ