00000000000000000000000000000000000000000000000000000000000000000000000000000000000000000000000000000000000000000000000000000000000000000000000000000000000000000000000000000000000000000000000000000000000000000000000000000000
00000000000000000000000000000000000000000000000000000000000000000000000000000000000000000000000000000000000000000000000000000000000000000000000000000000000000000000000000000000000000000000000000000000000000000000000000000000
00000000000000000007380000000000000073380000000000000000000000000007380000000000000073380000000000000000000000000007380000000000000073380000000000000000000000000007380000000000000073380000000000000000000000000007380000000000
00000000738000000009400000073338000094400000000000000000738000000009400000073338000094400000000000000000738000000009400000073338000094400000000000000000738000000009400000073338000094400000000000000000738000000009400000073338
00000000940000000000000000094440000000000000000000000000940000000000000000094440000000000000000000000000940000000000000000094440000000000000000000000000940000000000000000094440000000000000000000000000940000000000000000094440
00000000000000000000000000000000000000000000000000000000000000000000000000000000050555550005550000000000000000000000000005550000500500000000000000000000000000000000000000000000000000000000220000000000000000000000000000000000
00000000000000000000000000000000000000000000000000000000000000000000000000000000000000000000000000000000000000000000000000000000000000000000000000000000000000000000000000000000000000000002220000000000000000000000000000000000
00000000000000000000000000000000000000000000000000000000000000000000000000000000000000000000000000000000000000000000000000000000000000000000000000000000000000000000000000000000000000000022220000000000000000000000000000000000
00000000000000000000000000000000000000000000000000000000000000000000000000000000000000000000000000000000000000000000000000000000000000000000000000000000000000000000000000000000000000000222220000000000000000000000000000000000
00000000000000000000505050000000000000000000000000000000000000000000000000000505000000000000000000005000000000000000005000000000055000000200200000000002200200000000000055050000000000002222220000000000000000000000000000000000
00000000000000000000000000000000000000000000000000000000000000000000000000000000000000000000000000000000000000000000000000000000000000002200220000000022200220000000000000000000000000022222220000000000000000000000000000000000
00000000000000000000000000000000000000000000000000000000000000000000000000000000000000000000000000000000000000000000000000000000000000022200222000000222200222000000000000000000000000222222220000000000000000000000000000000000
00000000000066600000000060000000000000000066000000000000000066600000000060000000000000000066000000000000000066600000000060000000000000222266222200002222200222200000000060000000000002222222220000000020000000000000000060000000
11001111111111111111110111111111111111110111111111100011111111111111100111111111111111000111111110001111111011111100011111110001000111111111111111111111100111111111111111111100011111111111111111111111111111111111111111111111
11111111111111111111111111111111111111111111111111111111111111111111100111111111111111000111111111111111111111111111111111111111111111111111111111111111100111111111111111111111111111111111111111111111111111111111111111111111
