000000000000000000000000000000000000000000000000000000000000000000000000000000000000000000000000000000000000000000000000000000000000000000000000000000000000000000000000000000000000000000000000000000000000000000000000000000000000000000000000000000000000000000000000000000000000000000000000000000000000
000000000000000000000000000000000000000000000000000000000000000000000000000000000000000000000000000000000000000000000000000000000000000000000000000000000000000000000000000000000000000000000000000000000000000000000000000000000000000000000000000000000000000000000000000000000000000000000000000000000000
000000000000000000000000000000000000000000000000000000000000000000000000000000000000000000000000000000000000000000000000000000000000000000000000000000000000000000000000000000000000000000000000000000000000000000000000000000000000000000000000000000000000000000000000000000000000000000000000000000000000
000000000000000000000000000000000000000000000000000000000000000000000000000000000000000000000000000000000000000000000000000000000000000000000000000000000000000000000000000000000000000000000000000000000000000000000000000000000000000000000000000000000000000000000000000000000000000000000000000000000000
0000000000000000000000000000000000000000000000000000000000000000000000000000000000000000000000000000000000000000000000000000000000000000B0000000000000000000000000000000000000000000000000000000000000000000000000000000000000000000000000000000000000000000000000000000000000000000000000000000000000000000
000000000000000000000000000000000000000000000000000000000000000000000000000000000000000000000000000000000000000000000000000000000000000000000000000000000000000000000000000000000000000B00000000055555555555555555000000000000000000000000000000000000000000000000000000000000000000000000000000000000000000
00000000000000000000000000000000000000000000000000000000000000000000000000000000000000000000000000000000000000000000000B000000000000000000000000000000000000b00000000000000000000000000000000000050000000000000005000000000000000000000000000000000000000000000000000000000000000000000000000000000000000000
00000000000000000000000000000000000000000000000000000000000007870000000000000000000000000000000000000000B000000000000000000000000000000000000000000000000000000000000000000000000000000000000000050000000000000005000000000000000000000000000000000000000000000000000000000000000000000000000000000000000000
0000000000000000000000000000000000000000000000000000000000000000000000000000000000000000000000000000000000000000000000000000000000b7700000000000000000000CC00000000000000000005577755000000000b0000000000007008005000000000000000000000000000000000000000000000000000000000000000000000000000000000000000000
000000000000000000800000000000000C000000000000000000000000000M00M0000000000000000000000b000000000b0000000000000000000000000000000000000000000000000000000CC0000000000000000000000000000000000000000000000000000005000000000000000000000000000000000000000000000000000000000000000000000000000000000000000000
00000000000000000000000000000000000000000000000000000000000222222220000000000000000000000000000000000000000000000000000000000000000000000000000000M00M000111100000000000000M0M000000000000000000000CCC000000000005000000000000000000000000000000000000000000000000000000000000000000000000000000000000000000
0000000000000000000000000000000000000000000000000000000C0C0000000000C0C00000000000000000000000C000000000000000000C0000C0000000001111111001111111111111111111111111111111111111111111111111111111150CCC000555555555000000000000000000000000C0000000C0000000000000000000000000000C00000000000B0000000000000000
0000000000000000C0C0C0000000000200020000000000000000000000000000000000000000000000000000000000C000000000000000000C0000C0000000000000000000000000000000000000000000000000000000000000000000000000050CCC000555555555000000000000000000000000C0000000C0000000000000000000000000000C0000000000000000000020000000
000000000000000555555500000000220002200000000000000000222220000000022220000000000000000557070555220000000000000005757550000000110000000CC0000000000000000000000000000000000000000000000000000000055555500000000000000000000000000000000000257585752000000000000000000000000000000000000000000000000220000000
0000000000000000000000000000022200022200000000000000000000000000000000000000000000000000000000002220000000000000000000000000000000000001100000000000000000000000000000000000000000000000000000000000000000000000000000000000000000000000000000000000000000000000000000000000C2000200000000000000CC2220000000
000000000000000000000000000022220002222000000000000000000000000000000000000000000000000000000000222200000000000000000000000011000000000000000000000000000000000000000000000000000000000000000000000000000000000000000000000000000000000000000000000000000000000000000000000022000220000000000000222220000000
000000000000000000M00000000222220002222200M000000000000000000000000000000000000M0M00000000000000222220000000000M000000M00000000000000000000000000000000000000000000000000000000000000000000000000000000000000000000000000000000M0000M0000000000000000000000000000000000000022200022200000M000002222220000000
111111111111111111111111111111110001111111111111111111000000000000000001111111111111111111111111111111110001111111111111111100000000000000000000000000000000000000000000000000000000000000011111111111111111111111111111111111111111111111111111111111111111111111111111111111000111111111111111111111111111
111111111111111111111111111111110001111111111111111111000000000000000001111111111111111111111111111111110001111111111111111100000000000000000000000000000000000000000000000000000000000000011111111111111111111111111111111111111111111111111111111111111111111111111111111111000111111111111111111111111111
111111111111111111111111111111110001111111111111111111000000000000000001111111111111111111111111111111110001111111111111111100000000000000000000000000000000000000000000000000000000000000011111111111111111111111111111111111111111111111111111111111111111111111111111111111000111111111111111111111111111