00000000000000000000000000000000000000000000000000000000000000000000000000000000000000000000000000000000000000000000000000000000000000000000000000000000000000000000000000000000000000000000000000000000000000000000000000000000
00000000000000000000000000000000000000000000000000000000000000000000000000000000000000000000000000000000000000000000000000000000000000000000000000000000000000000000000000000000000000000000000000000000000000000000000000000000
00000000000000000000000000000000000000000000000000000000000000000000000000000000000000000000000000000000000000000000000000000000000000000000000000000000000000000000000000000000000000000000000000000000000000000000000000000000
00000000000000000000000000000000000000000000000000000000000000000000000000000000000000000000000000000000000000000000000000000000000000000000000000000000000000000000000000000000000000000000000000000000000000000000000000000000
00000000000000000000000000000000000000000000000000000000000000000000000000000000000000000000000000000000000000000000000000000000000000000000000000000000000000000000000000000000000000000000000000000000000000000000000000000000
00000000000000000000000000000000000000000000000000000000000000000000000000000000000000000000000000000000000000000000000000000000000000000000000000000000000000000000000000000000000000000000000000000000000000000000000000000000
00000000000000000000000000000000000000000000000000000000000000000000000000000000000000000000000000000000000000000000000000000000000000000000000000000000000000000000000000000000000000000000000000000000000000000000000000000000
00000000000000000000000000000000000000000000000000000000000000000000000000000000000000000000000000000000000000000000000000000000000000000000000000000000000000000000000000000000000000000000000000000000000000000000000000000000
00000000000000000000000000000000000000000000000000000000000000000000000000000000000000000000000000000000000000000000000000000000000000000000000000000000000000000000000000000000000000000000000000000000000000000000000000000000
0000000000000000000000000000000000000000000000000000000000000000000000000000000000b00b000000000000000000000000000000000000000000000000000000000000000000000000000000000000000000000000000000000000000000000000000000000000000000
00000000000000000000000000000000000000000000000000000000000000000000000000000000055555550005555800000000000000000000000005550000577500000000000000000000000000000000000000000000000000000000220000000000000000000000000000000000
00000000000000000000000000000000000000000000000000000000000000000000000000000000000000000000000000000000000000000000000000000000000000000000000000000000000000000000000000000000000000000002220000000000000000000000000000000000
00000000000000000000000000000000000000000000000000000000000000000000000000000000000000000000000000000000000000000000000000000000000000000000000000000000000000000000000000000000000000000022220000000000000000000000000000000000
00000000000000000000000000000000000000000000000000000000000000000000000000000CCC000000000000000000000000000000000000000000000000000000000000000000000000000000000000000000000000000000000222220000000000000000000000000000000000
00000000000000070000575850000000000000CC0000000000000000000Hh0000000000000000575000000000000000500008008007000080007005000000000055000000200200000000002200200000000000055850000000000002222220000000000000000000000000000000000
00000000000000000000000000000000000000Hh0000000000000000000Pp0000000000000000000000000000000000000000000000000000000000000000000000000002200220000000022200220000000000000000000000000022222220000000000000000000000000000000000
000000000000000000000000000000Hh000000Pp0000000000000000000Pp00000000000000000000000000000000000000000000000000000000000000000000000000222002220000002222002220000Hh000000000000000000222222220000000000000000000000000000000000
0000000000000000000000M0000000Pp0M0000Pp00000000000M0M00000Pp000000000000000000000000000000000000M0M000000000000000000000000b000M0M0002222002222000022222002222000Pp0000000000M0M000022222222200000000F0000000000000000000000000
11111111111111111111111111111111111111111111111111111111111111111111100111111111111111000111111111111111111111111111111111111111111111111111111111111111100111111111111111111111111111111111111111111111111111111111111111111111
66666666666666666666666666666666666666666666666666666666666666666666600666666666666666000666666666666666666666666666666666666666666666666666666666666666600666666666666666666666666666666666666666666666666666666666666666666666
666666666666666666666666666666666666666666666666666666666666666666666WW666666666666666WWW6666666666666666666666666666666666666666666666666666666666666666WW666666666666666666666666666666666666666666666666666666666666666666666